Sybil A|Sybil Kailena
Yarina A|Yarina P
Rinna|Rinna Ly
Shania Vega|Shania Vegax
Sabrisse A|Sabrisse Aaliyah
Viola Bailey|Viola Paige
Ryana|Stefani Kovalyova
Viola Oh|Viola Paige
Silvia Wise|Sylvia Wise
Vicki Wade|Vickie Wade
Viola Bailey|Viola Oh
Adel More|Adel Morel
Tracy Delicious|Tracy Lindsay
Suzanna A|Suzanna Aye
Sally Minx|Sapphire
Sam Tye|Sammi Tye
Zuzana Z|Zuzana Zeleznovova
Sarika A|Sarika Ahe
Silvie|Silvie Delux
Sabrisse|Sabrisse A
Vanessa A|Vanessa Angel
Sara Luv|Sara Luvv
Sabrisse|Sabrisse Aaliyah
Xene|Xene Jay
Sybil A|Sybil A Kailena
Nici Roxx|Ti Sato
Roxanna Milan|Roxanne Milana
Sophia Sweet|Sweet Sophia
Sybil A Kailena|Sybil Kailena
Taya|Vikky
Sofia The Bum|Zuzu Sweet
Sophie Moone|Sophie Sweet
Selena Rose|Selena Santana
Zelda B|Zelda Bee
Skye Wood|Skye Young
Victoria Rae|Victoria Rae Black
Rita Y|Tanya Grace
Vanea|Viola Paige
Vanea|Viola Bailey
Abella Danger|Abella Danger Pics
Violette Pink|Violette Pure
Sarah Nicola Randall|Sarah Randall
Viola O|Viola Paige
Veronica Zemanova|Veronika Zemanova
Eva Shanti|Taissia Shanti
Yoha|Yoha Galvez
Val Steele|Valerica Steele
Ginger Elle|Skyla Novea
Tiana Blow|Tori Mack
Slimthick Vic|Vic Marie