Janyk Brones|Yanik
Charma Kelly|Ruby Redbottom
Angie Eliff|Angie Elif
Lucie Kline|Lucie Cline
Kami Hermanova|Kami Arias
Joleyn Burst|Joelyn Burst
Ana Gibb|Anais
Christy Lynn|Christy Anderson
Joanna Meadows|Jo Jo
Maria Lee|Maria K
Jessi Lee|Sedona Reign
Sapphire Blue|Megan Sweets
Debora Alta|Debora A
Jessica Ohare|Jessica OHare
Angela Haddie|Diana Dee
Jessie Parker|Mattie Borders
Adel Morel|Adel More
Ashley Doll|Taylor Ashley
Alexa Nicole|Aleksa Nicole
Brooke Van Buuren|Brooke
Natalia Andreeva|Delilah G
Lichelle Marie|Lachelle Marie
Jenny Fer|Jenny Ferri
Olivia Cassi|Dzhili
Christina Cavazos|Darina
Poly White|Polly White
Suzanna Aye|Suzanna A
Mary Fox|Mara Gri
Julija Roberta|Nikoletta
Leyla Falcon|Leya Falcon
Cristal Houston|Aubrey Shawinsky
Yenn Cat|Agrus
Anna Morna|Anastasia Morna
Elloise|Elfiolla
Chyna White|Dragon Lily
Kris The Foxx|Kristi Fox
Ashley Rabbit|Ashly Rabbit
Natalia Andreeva|Danica Jewels
Casey Nohrman|Casey Norhman
Darina Litvinova|Candice Brielle
