Amelie Lou|Clarice A
Amy Moloko|Any Moloko
Anna Goncharenko|Marit
Averi Brooks|Avery Brooks
Blake Eden|Blake Bartelli
Altea Belinda|Andreea Mantea
Aspen Martin|Aspen Parker
Sally Minx|Sapphire
Angelina Socho|Angelina Sokolova
Chikita|Cikita
Amalia Davis|Amalia Devis
Krystal Boyd|Anjelica
Holly Belle|Holly Anderson
Leanne Lace|Lee Anne
Jessica Brooks|Jessica Lynette Brooks
Angel B Megan|Angel B|Lucretia 
Karianne|Taya
Claire Shelty|Betty Swan
Cipriana|Cipriana Maxima
Muna|July
Angel Windell|Angel Wendell
Julia Morozzi|Jula
Audrey Allen|Audrey Aleen Allen
Abel Rugolmaskina|Alice N
Angel B Megan|Lucretia K
Stacy Swan|Emily Swan
Cinthia Doll|Chintia Doll
Candice Cardinele|Candice Cardinelle
Jessica Night|Jessika Night
An Yabuki|Ann Yabuki
Chloe Anderson|Chloe Karlova
Holly Molly|Jessie Way
Vicki Wade|Vickie Wade
Mia Lee|Nedda A
Joana Jakes|Ava Austin
Anna Melody|Melody Y
Karma RX|Karma Rx
Jana Jordan|Jana Foxy
Nici Dee|Nici Roxx
Roxanne Milana|Roxanna Milan
Samadhi Amour|Mila Amour
Angel Sky|Sky Angel
Tracy Delicious|Tracy Lindsay
Annalena Reno|Milena
Mayuko Ryuzu|Mayuko
Jezabel Vessir|Jezebel Vessir
Anna Akana|Anna F Tatielle
